きみのことがだいだいだいだいだ	君のことが大大大大大好きな100人の彼女	ja-JP
おはなのみつだいがく	お花の蜜大学	ja-JP
おはなのみつだいがくふぞくこう	お花の蜜大学附属高等学校	ja-JP
おはなのみつこうこう	お花の蜜高校	ja-JP
じゅらしっくこうこう	寿裸漆区高校	ja-JP
すきすぎちょう	梳杉町	ja-JP
きらいすぎちょう	木雷杉町	ja-JP
ふつうちょう	不津宇町	ja-JP
どちらかといえばすきちょう	度血裸加戸家場酢木町	ja-JP
ごりられんごう	呉莉羅連合	ja-JP
あいじょうれんたろう	愛城恋太郎	ja-JP
あいじょう	愛城	ja-JP
れんたろう	恋太郎	ja-JP
はなぞのはかり	花園羽香里	ja-JP
はなぞの	花園	ja-JP
はかり	羽香里	ja-JP
いんだからね	院田唐音	ja-JP
いんだ	院田	ja-JP
からね	唐音	ja-JP
よしもとしずか	好本静	ja-JP
よしもと	好本	ja-JP
しずか	静	ja-JP
えいあいなの	栄逢凪乃	ja-JP
えいあい	栄逢	ja-JP
なの	凪乃	ja-JP
やくぜんくすり	薬膳楠莉	ja-JP
やくぜん	薬膳	ja-JP
くすり	楠莉	ja-JP
はなぞのははり	花園羽々里	ja-JP
ははり	羽々里	ja-JP
はらがくるみ	原賀胡桃	ja-JP
はらが	原賀	ja-JP
くるみ	胡桃	ja-JP
めいどめい	銘戸芽衣	ja-JP
めいど	銘戸	ja-JP
めい	芽衣	ja-JP
すとういく	須藤育	ja-JP
すとう	須藤	ja-JP
いく	育	ja-JP
うつくしすぎみみみ	美杉美々美	ja-JP
うつくしすぎ	美杉	ja-JP
みみみ	美々美	ja-JP
かくれめめ	華暮愛々	ja-JP
かくれ	華暮	ja-JP
めめ	愛々	ja-JP
いいんちよ	伊院知与	ja-JP
いいん	伊院	ja-JP
ちよ	知与	ja-JP
やまとなでしこ	大和撫子	ja-JP
やまと	大和	ja-JP
なでしこ	撫子	ja-JP
やさしきやまめ	優敷山女	ja-JP
やさしき	優敷	ja-JP
やまめ	山女	ja-JP
もみもみじ	茂見紅葉	ja-JP
もみ	茂見	ja-JP
もみじ	紅葉	ja-JP
やくぜんやく	薬膳ヤク	ja-JP
やく	ヤク	ja-JP
とろとろきしか	土呂瀞騎士華	ja-JP
とろとろ	土呂瀞	ja-JP
きしか	騎士華	ja-JP
けだるいあーしー	毛樽井亜愛子衣	ja-JP
けだるい	毛樽井	ja-JP
あーしー	亜愛子衣	ja-JP
なかじうと	中二詩人	ja-JP
なかじ	中二	ja-JP
うと	詩人	ja-JP
めいどまい	女井戸妹	ja-JP
めいど	女井戸	ja-JP
まい	妹	ja-JP
ぼんのうじももは	盆能寺百八	ja-JP
ぼんのうじ	盆能寺	ja-JP
ももは	百八	ja-JP
ばいおりん	灰尾凛	ja-JP
ばいお	灰尾	ja-JP
りん	凛	ja-JP
ひふみすう	一二三数	ja-JP
ひふみ	一二三	ja-JP
すう	数	ja-JP
かほえいら	火保エイラ	ja-JP
かほ	火保	ja-JP
えいら	エイラ	ja-JP
ねこなりたま	猫成珠	ja-JP
ねこなり	猫成	ja-JP
たま	珠	ja-JP
さいきひめか	才奇姫歌	ja-JP
さいき	才奇	ja-JP
ひめか	姫歌	ja-JP
でいまつり	出井祭李	ja-JP
でい	出井	ja-JP
まつり	祭李	ja-JP
うさみしいな	宇佐美椎奈	ja-JP
うさみ	宇佐美	ja-JP
しいな	椎奈	ja-JP
ぜつぼうだめる	雪房田夢留	ja-JP
ぜつぼうだ	雪房田	ja-JP
める	夢留	ja-JP
ともがらさき	輩先	ja-JP
ともがら	輩	ja-JP
さき	先	ja-JP
ねむいねむ	根向井寧夢	ja-JP
ねむい	根向井	ja-JP
ねむ	寧夢	ja-JP
はすはすは	端須蓮葉	ja-JP
はす	端須	ja-JP
はすは	蓮葉	ja-JP
もりきたきまり	守北季鞠	ja-JP
もりきた	守北	ja-JP
きまり	季鞠	ja-JP
ふたてえる	双天彗流	ja-JP
ふたて	双天	ja-JP
える	彗流	ja-JP
